date
2020-02-01
2020-03-07
2020-05-02
2020-06-13
2020-09-05
2020-10-03
